90 90 90 90 90 90 90 90 90 90 90 90 90 90 90 90 90 90 90 90 90 90 90 90 90 90 90 90 90 90 90 90 90 90 90 90 90 90 90 90 90 90 90 90 90 90 90 90 90 90 
90 90 90 90 90 90 90 90 90 90 90 90 90 90 90 90 90 90 90 90 90 90 90 90 90 90 90 90 90 90 90 90 90 90 90 90 90 90 90 90 90 90 90 90 90 90 90 90 90 90 
90 90 90 90 90 90 90 90 90 90 90 90 90 90 90 90 90 90 90 90 90 90 90 90 90 90 90 90 90 90 90 90 90 90 90 90 90 90 90 90 90 90 90 90 90 90 90 90 90 90 
90 90 90 90 90 90 90 90 90 90 90 90 90 90 90 90 90 90 90 90 90 90 90 90 90 90 90 90 2 26 4 4 26 24 90 90 90 90 90 90 90 90 90 90 90 90 90 90 90 90 
90 90 90 90 2 3 3 3 3 3 3 3 3 3 3 3 3 3 3 3 3 3 3 3 3 3 3 3 11 17 0 0 15 12 3 3 3 3 3 3 3 3 3 3 3 24 90 90 90 90 
90 90 90 90 21 17 15 23 7 17 15 15 15 15 15 15 15 15 15 15 15 15 15 15 15 15 15 23 21 30 0 0 0 0 0 0 0 0 0 0 0 0 0 0 0 23 90 90 90 90 
90 90 90 90 21 30 0 23 7 29 0 0 0 0 0 0 0 0 0 0 0 0 0 0 0 0 0 23 21 30 0 0 0 0 0 0 0 0 0 0 0 0 0 0 0 23 90 90 90 90 
90 90 90 90 21 30 0 23 34 70 66 70 55 0 0 39 70 70 70 70 66 66 70 70 55 0 0 23 21 30 0 0 0 39 40 44 0 54 70 70 70 66 55 0 0 23 90 90 90 90 
90 90 90 90 21 30 0 12 3 3 3 24 7 44 0 23 2 3 3 3 3 3 3 24 21 44 0 23 21 30 22 0 0 23 21 29 0 53 2 3 3 3 11 44 0 23 90 90 90 90 
90 90 90 90 21 30 0 27 15 15 15 23 7 29 0 23 21 17 15 15 15 15 15 23 21 30 0 23 21 29 0 0 0 23 21 30 0 53 21 17 15 15 15 16 0 23 90 90 90 90 
90 90 90 90 21 30 0 0 0 0 0 23 7 30 0 23 21 30 0 0 0 0 0 23 21 30 0 23 21 30 22 42 0 23 21 30 0 53 21 30 0 0 0 0 0 23 90 90 90 90 
90 90 90 90 21 30 0 54 55 0 0 23 7 29 0 23 21 29 0 39 36 36 36 38 21 30 0 23 21 30 0 0 0 23 21 30 0 53 34 70 70 66 70 66 70 23 90 90 90 90 
90 90 90 90 21 30 0 53 65 44 0 12 11 30 0 23 21 30 0 12 3 3 3 3 11 30 0 23 21 30 0 0 0 12 11 29 0 12 14 14 24 2 3 3 3 23 90 90 90 90 
90 90 90 90 21 30 0 53 7 30 0 27 15 16 0 23 21 29 0 27 15 15 15 15 15 16 0 23 21 29 0 0 0 27 15 16 0 27 15 15 23 7 17 15 15 23 90 90 90 90 
90 90 90 90 21 30 48 53 7 30 0 0 0 0 0 23 21 30 0 0 0 0 0 0 0 0 0 23 21 30 0 0 0 0 0 0 22 0 0 0 23 7 29 0 0 23 90 90 90 90 
90 90 90 90 21 69 66 67 34 70 66 66 67 0 0 23 34 66 66 70 70 70 70 66 70 70 66 38 34 71 69 70 70 66 70 70 55 0 0 0 23 7 30 0 0 23 90 90 90 90 
90 90 90 90 21 3 3 14 14 14 14 14 11 44 0 12 3 3 3 3 3 3 3 3 3 3 3 3 3 3 3 3 3 3 3 3 11 44 0 0 12 11 30 0 0 23 90 90 90 90 
90 90 90 90 21 15 15 15 15 15 15 15 15 16 0 27 15 15 15 15 15 15 15 15 15 15 15 15 15 15 15 15 15 15 15 15 15 16 0 0 27 15 16 0 0 23 90 90 90 90 
90 90 90 90 21 0 0 0 0 0 0 22 42 0 0 0 0 0 0 0 0 0 0 0 0 0 0 0 0 0 0 0 0 0 0 0 0 0 0 0 0 0 22 0 0 23 90 90 90 90 
90 90 90 90 21 0 0 0 0 0 0 0 0 0 0 0 0 0 0 90 90 0 0 0 0 0 0 0 0 0 0 0 0 0 0 0 0 0 0 0 0 0 0 0 0 23 90 90 90 90 
90 90 90 90 21 0 0 90 90 90 90 90 90 90 90 90 90 0 0 90 90 0 0 0 90 90 90 90 90 90 90 90 90 90 90 90 90 90 90 90 90 90 0 0 0 23 90 90 90 90 
90 90 90 90 21 0 0 90 90 90 90 90 90 90 90 90 90 0 0 90 90 0 0 0 90 90 90 90 90 90 90 90 90 90 90 90 90 90 90 90 90 90 0 0 0 23 90 90 90 90 
90 90 90 90 21 0 0 48 0 0 0 0 0 0 0 90 90 0 0 90 90 0 0 0 0 0 48 0 0 0 0 0 0 0 0 0 0 0 0 0 90 90 0 0 0 23 90 90 90 90 
90 90 90 90 21 0 0 0 0 0 0 0 0 0 0 90 90 0 0 90 90 0 0 0 0 0 0 0 0 0 0 0 0 0 0 0 0 0 0 0 90 90 0 0 0 23 90 90 90 90 
90 90 90 90 21 90 90 90 90 90 90 90 90 0 0 90 90 0 0 90 90 0 0 0 90 90 0 0 90 90 90 90 90 90 90 90 90 0 0 0 90 90 0 0 0 23 90 90 90 90 
90 90 90 90 21 90 90 90 90 90 90 90 90 0 0 90 90 0 0 90 90 0 0 0 90 90 0 0 90 90 90 90 90 90 90 90 90 0 0 0 90 90 0 0 48 23 90 90 90 90 
90 90 90 90 21 0 0 0 0 0 0 22 0 0 0 90 90 22 0 90 90 0 0 0 90 90 0 0 90 90 0 0 0 0 48 90 90 0 0 0 90 90 0 0 0 23 90 90 90 90 
90 90 90 90 21 0 0 0 0 0 48 0 0 0 0 90 90 0 0 90 90 48 42 0 90 90 0 0 90 90 0 0 0 0 0 90 90 0 0 0 90 90 0 0 0 23 90 90 90 90 
90 90 90 90 21 0 0 90 90 90 90 90 90 90 90 90 90 0 0 90 90 0 0 0 90 90 0 22 90 90 90 90 0 0 0 90 90 0 0 0 90 90 0 42 0 23 90 90 90 90 
90 90 90 90 21 0 0 90 90 90 90 90 90 90 90 90 90 0 0 90 90 0 0 0 90 90 0 0 90 90 90 90 0 0 0 90 90 0 0 0 90 90 0 0 0 23 90 90 90 90 
90 90 90 90 21 48 0 90 90 0 0 90 90 0 0 0 0 0 0 0 0 0 0 0 90 90 0 0 0 0 0 0 0 0 0 90 90 0 0 0 90 90 0 0 0 23 90 90 90 90 
90 90 90 90 21 0 0 90 90 0 0 90 90 0 0 0 0 0 0 0 0 0 0 0 90 90 0 0 0 0 0 0 0 0 0 90 90 0 0 0 0 0 0 0 0 23 90 90 90 90 
90 90 90 90 21 0 0 90 90 0 0 90 90 0 0 90 90 90 90 90 90 90 0 0 90 90 90 90 90 90 90 90 0 0 0 90 90 0 0 0 0 0 0 0 0 23 90 90 90 90 
90 90 90 90 21 0 0 90 90 0 0 90 90 0 0 90 90 90 90 90 90 90 0 0 90 90 90 90 90 90 90 90 0 0 0 90 90 0 0 0 0 0 0 0 0 23 90 90 90 90 
90 90 90 90 21 0 0 90 90 0 0 90 90 0 0 90 90 0 0 0 90 90 0 0 22 0 0 48 22 0 90 90 0 0 0 90 90 0 0 0 0 0 0 0 0 23 90 90 90 90 
90 90 90 90 21 0 0 90 90 0 0 90 90 0 0 90 90 0 0 0 90 90 0 0 0 0 0 0 0 0 90 90 0 0 0 90 90 0 0 0 90 90 90 90 90 23 90 90 90 90 
90 90 90 90 21 0 0 90 90 0 0 90 90 0 0 90 90 0 0 0 90 90 90 90 90 90 90 90 90 90 90 90 0 22 0 90 90 0 0 0 90 90 90 90 90 23 90 90 90 90 
90 90 90 90 21 0 0 90 90 0 0 90 90 0 48 0 0 0 0 0 90 90 90 90 90 90 90 90 90 90 90 90 0 0 22 90 90 0 0 0 0 22 0 0 0 23 90 90 90 90 
90 90 90 90 21 0 0 90 90 0 0 90 90 0 0 0 0 0 0 0 0 22 0 0 0 0 0 0 0 0 0 0 0 0 0 90 90 0 0 0 48 0 0 0 0 23 90 90 90 90 
90 90 90 90 21 0 0 0 0 0 0 90 90 0 0 0 0 0 0 0 0 0 0 0 0 0 0 0 0 0 0 0 0 0 0 90 90 90 90 90 90 90 90 90 90 23 90 90 90 90 
90 90 90 90 21 0 48 0 0 0 0 90 90 0 0 0 0 90 90 90 90 90 90 90 90 90 90 90 90 90 90 90 0 0 0 90 90 90 90 90 90 90 90 90 90 23 90 90 90 90 
90 90 90 90 21 0 0 0 0 0 0 90 90 0 0 0 0 90 90 90 90 90 90 90 90 90 90 90 90 90 90 90 0 0 0 0 0 0 0 22 0 0 0 42 0 23 90 90 90 90 
90 90 90 90 21 0 0 0 42 0 0 90 90 0 0 0 0 90 90 0 0 0 0 0 0 0 0 0 0 42 0 0 0 0 0 0 0 0 0 0 0 0 22 0 0 23 90 90 90 90 
90 90 90 90 21 0 0 0 0 0 0 90 90 0 42 0 0 90 90 0 0 0 0 0 0 0 0 0 0 0 0 0 0 0 0 22 0 0 0 0 0 0 0 0 0 23 90 90 90 90 
90 90 90 90 21 0 0 0 0 0 0 90 90 22 0 0 0 90 90 0 0 0 0 22 0 0 0 0 0 22 0 0 0 0 0 0 0 0 0 0 0 0 0 0 0 23 90 90 90 90 
90 90 90 90 34 37 37 37 37 37 37 37 40 0 0 0 0 39 37 37 37 37 37 37 37 37 37 37 37 37 37 37 37 37 37 37 37 37 37 37 37 37 37 37 37 38 90 90 90 90 
90 90 90 90 90 90 90 90 90 90 90 90 21 81 81 81 81 23 90 90 90 90 90 90 90 90 90 90 90 90 90 90 90 90 90 90 90 90 90 90 90 90 90 90 90 90 90 90 90 90 
90 90 90 90 90 90 90 90 90 90 90 90 90 90 90 90 90 90 90 90 90 90 90 90 90 90 90 90 90 90 90 90 90 90 90 90 90 90 90 90 90 90 90 90 90 90 90 90 90 90 
90 90 90 90 90 90 90 90 90 90 90 90 90 90 90 90 90 90 90 90 90 90 90 90 90 90 90 90 90 90 90 90 90 90 90 90 90 90 90 90 90 90 90 90 90 90 90 90 90 90 
90 90 90 90 90 90 90 90 90 90 90 90 90 90 90 90 90 90 90 90 90 90 90 90 90 90 90 90 90 90 90 90 90 90 90 90 90 90 90 90 90 90 90 90 90 90 90 90 90 90 
