90 90 90 96 90 90 90 90 90 90 90 96 90 90 90 90 90 90 90 96 90 90 90 90 90 90 96 90 90 90 76 90 90 90 90 90 90 90 90 90 90 90 90 90 90 90 90 90 90 90 
90 76 90 90 64 90 90 76 64 90 90 90 90 90 90 76 64 64 90 90 90 90 64 90 90 90 96 90 90 96 90 90 90 90 90 90 64 90 90 90 90 90 64 90 90 90 90 76 64 90 
90 64 90 90 76 90 90 90 64 64 90 90 90 90 90 90 90 90 90 96 90 90 64 90 90 90 90 90 90 90 90 90 90 90 90 90 90 90 64 90 90 90 90 90 96 90 90 90 64 90 
90 90 90 90 90 90 90 90 90 90 96 90 90 96 90 90 96 90 90 90 90 90 96 76 90 90 90 90 2 26 4 4 26 24 90 90 90 90 76 90 76 90 90 90 90 90 90 90 90 90 
90 90 90 96 2 3 3 3 3 3 3 3 3 3 3 3 3 3 3 3 3 3 3 3 3 3 3 3 11 17 0 0 15 12 3 3 3 3 3 3 3 3 3 3 3 24 96 96 90 96 
90 76 90 96 21 17 15 23 7 17 15 1 15 15 15 15 15 1 1 1 15 1 15 1 1 15 15 23 21 1 0 0 0 0 95 1 1 0 0 1 0 1 1 1 91 23 90 90 90 76 
90 90 90 90 21 30 91 23 7 29 1 1 1 1 0 91 0 0 1 0 1 0 1 0 0 1 1 23 21 1 1 0 1 0 1 0 1 91 0 0 1 0 1 0 1 23 90 96 90 90 
96 90 90 90 21 30 0 23 34 70 66 70 55 0 0 39 70 70 70 70 66 66 70 70 67 1 1 23 21 30 1 1 0 39 40 44 0 54 70 70 70 66 67 1 0 23 90 90 90 90 
90 96 64 90 21 30 0 12 3 3 3 24 7 1 0 23 2 3 3 3 3 3 3 24 21 1 1 23 21 30 1 0 0 23 21 1 1 53 2 3 3 3 11 1 1 23 90 90 90 90 
90 90 90 90 21 32 1 1 15 1 15 23 7 29 1 23 21 17 1 1 15 15 15 23 21 1 1 23 21 1 91 1 0 23 21 30 0 53 21 17 1 1 1 16 1 23 90 90 96 64 
90 90 90 90 21 30 1 0 1 1 0 23 7 30 0 23 21 30 1 1 0 0 95 23 21 30 1 23 21 30 1 1 0 23 21 1 1 53 21 30 95 32 0 1 1 23 90 90 90 90 
90 90 64 96 21 1 1 54 55 0 1 23 7 29 0 23 21 1 1 39 36 36 36 38 21 1 1 23 21 30 1 1 1 23 21 30 1 53 34 70 70 66 70 66 70 23 90 64 90 90 
90 90 90 90 21 30 1 53 65 1 0 12 11 1 1 23 21 91 0 12 3 3 3 3 11 30 0 23 21 1 1 1 0 12 11 1 1 12 14 14 24 2 3 3 3 23 90 90 90 96 
90 90 90 96 21 91 0 53 7 30 1 27 15 1 0 23 21 29 1 1 15 15 1 15 15 1 0 23 21 1 1 0 0 27 1 16 1 27 1 15 23 7 17 15 91 23 90 76 90 90 
90 96 90 90 21 30 48 53 7 30 1 1 1 0 0 23 21 1 1 0 0 1 0 1 1 0 91 23 21 30 1 1 0 1 91 0 22 1 1 1 23 7 1 0 0 23 90 90 64 90 
90 64 64 90 21 69 66 67 34 70 66 66 67 1 1 23 34 66 66 70 70 70 70 66 70 70 66 38 34 71 69 70 70 66 70 70 55 0 1 0 23 7 30 1 1 23 90 64 76 90 
90 90 90 90 21 3 3 14 14 14 14 14 11 44 0 12 3 3 3 3 3 3 3 3 3 3 3 3 3 3 3 3 3 3 3 3 11 1 0 1 12 11 30 1 0 23 90 90 90 90 
76 90 76 90 21 17 15 1 15 1 15 15 1 16 1 27 1 1 15 1 15 1 15 1 1 15 15 1 15 15 15 15 1 15 15 15 1 16 1 0 1 1 1 0 1 23 96 90 90 96 
90 90 90 90 21 1 91 1 1 1 1 22 42 91 1 1 0 0 1 1 0 1 1 0 91 1 1 1 32 1 1 0 1 1 1 1 91 1 0 1 1 1 22 1 0 23 90 90 90 90 
90 90 90 96 21 1 1 0 1 1 0 1 0 1 0 1 0 1 0 39 40 1 1 1 0 1 0 1 0 0 0 1 0 1 0 1 0 0 1 0 1 0 1 1 0 23 90 90 90 90 
90 90 90 90 21 30 0 65 66 66 66 66 66 66 66 66 55 0 0 53 51 0 0 0 65 70 70 69 70 70 70 66 70 70 66 70 70 66 70 70 70 67 0 1 0 23 90 64 90 90 
90 64 90 64 21 1 1 12 3 3 3 3 3 3 3 24 51 0 1 53 51 1 0 1 12 14 14 14 14 14 14 14 14 14 14 14 14 14 14 14 24 7 44 0 91 23 90 90 90 96 
96 90 90 64 21 1 1 48 1 1 15 15 1 15 1 53 51 1 0 53 51 1 1 1 27 91 48 1 15 1 1 1 1 1 15 15 15 1 15 15 23 7 30 1 1 23 90 96 90 90 
90 90 96 90 21 30 1 1 1 1 0 91 0 1 0 53 51 0 91 53 51 0 0 1 0 0 1 0 0 1 0 1 1 0 1 91 1 0 1 0 23 7 1 0 0 23 90 90 76 90 
90 90 90 96 21 71 70 69 66 70 70 70 67 0 1 53 51 1 1 53 51 1 0 1 39 40 44 1 54 70 70 66 66 66 70 70 55 1 0 1 23 7 1 1 0 10 90 90 90 90 
90 76 90 90 21 14 14 14 14 14 14 14 11 44 85 86 86 89 1 53 51 0 1 0 23 21 1 0 53 2 3 3 3 3 3 24 51 1 1 1 23 7 1 1 1 23 96 90 90 90 
90 90 96 90 21 91 1 15 1 1 15 22 1 1 1 53 51 22 1 53 51 0 0 1 23 21 1 1 53 21 17 95 1 15 48 10 51 0 1 0 23 7 30 1 0 23 90 90 64 90 
64 96 90 90 21 30 0 1 0 1 1 1 0 0 95 53 51 1 1 53 51 1 42 1 23 21 1 0 53 21 1 0 0 91 1 10 51 1 0 1 23 7 29 0 0 23 90 76 90 90 
90 90 90 64 21 1 1 53 88 88 88 88 88 88 88 38 51 1 0 53 51 0 1 0 23 21 30 1 53 34 88 40 1 0 0 10 51 0 1 0 23 7 1 1 0 23 90 90 96 90 
90 90 90 90 21 1 0 53 2 14 14 24 2 14 14 14 51 0 1 12 11 44 0 1 23 21 30 1 12 3 3 11 30 1 0 10 51 1 1 0 23 7 30 1 1 23 90 90 90 90 
90 90 76 90 21 48 1 53 51 27 15 10 21 17 1 15 0 1 0 15 15 1 0 0 23 21 1 0 27 1 1 15 1 0 1 10 51 0 1 91 12 11 1 0 0 23 90 96 90 96 
90 96 90 90 21 30 1 53 51 1 95 10 21 30 1 0 1 0 1 1 1 0 1 91 23 21 30 1 1 1 0 1 0 1 1 10 51 1 0 0 27 1 0 1 0 23 90 90 90 90 
90 90 90 90 21 1 1 53 51 0 0 10 21 1 0 39 65 70 66 70 66 67 0 1 23 34 70 70 66 70 66 67 0 0 1 10 51 0 1 1 1 1 32 0 1 23 90 64 96 90 
90 90 90 76 21 30 1 53 51 1 0 10 21 30 1 10 2 14 14 14 24 21 1 0 12 14 14 14 14 14 24 7 1 1 0 10 51 0 1 1 0 91 0 1 0 23 90 90 90 90 
90 96 90 90 21 1 1 53 51 0 1 10 21 1 0 10 21 17 15 1 23 21 30 1 22 1 1 48 1 15 10 7 1 0 1 10 51 1 0 1 0 1 0 1 0 23 90 90 90 90 
90 90 90 64 21 30 0 53 51 1 0 10 21 1 1 10 21 30 91 0 23 21 1 0 0 1 1 95 0 1 10 7 30 1 0 10 51 0 1 0 39 36 36 36 36 23 90 90 64 90 
96 64 90 96 21 30 1 53 51 0 1 10 21 30 1 12 11 30 1 1 23 34 65 70 70 66 70 69 66 70 38 7 1 22 1 10 51 1 1 0 12 3 3 3 3 23 90 90 90 90 
90 90 90 90 21 30 1 53 51 0 1 10 21 30 48 0 1 1 0 0 12 14 14 14 14 14 14 14 14 14 14 11 30 91 22 10 51 0 1 1 27 1 15 1 15 23 90 90 90 96 
90 76 90 76 21 1 0 54 55 1 0 10 21 1 0 91 0 0 1 0 27 22 15 1 15 1 15 1 1 15 1 15 1 1 0 10 51 1 0 0 48 0 1 0 95 23 90 96 90 90 
90 90 90 90 21 30 1 1 0 1 1 10 21 30 1 0 32 0 1 1 0 1 1 0 0 1 0 1 0 1 0 0 0 1 1 10 65 66 70 70 66 69 70 70 66 23 90 96 90 90 
90 64 90 90 21 30 48 1 0 0 1 10 21 1 1 0 0 65 70 66 66 70 70 69 70 66 70 70 66 70 69 67 0 1 0 12 3 3 3 3 3 3 14 14 14 23 90 90 64 90 
90 90 90 96 21 30 0 1 32 0 0 10 21 30 1 1 1 23 2 14 14 14 14 14 14 14 14 14 14 14 14 11 44 1 0 1 1 15 15 22 1 15 1 15 15 23 90 90 76 90 
96 90 90 96 21 1 1 0 42 91 0 10 21 1 0 0 1 23 21 17 1 91 15 1 1 32 15 1 15 1 1 15 1 0 1 0 1 0 0 91 0 1 22 1 1 23 96 90 90 90 
90 90 90 90 21 30 91 0 1 0 1 10 21 30 42 1 0 23 21 1 1 0 1 1 0 1 0 1 1 0 1 1 0 0 0 22 1 1 1 0 1 0 1 0 0 23 90 90 90 64 
90 90 64 90 21 1 1 0 0 1 1 10 21 30 0 1 1 23 21 29 1 1 1 22 0 1 1 0 0 1 0 1 1 0 91 0 0 1 0 1 32 0 1 0 91 23 90 64 90 90 
90 90 90 90 34 37 37 37 37 37 37 37 37 36 63 63 36 37 37 37 37 37 37 37 37 37 37 37 37 37 37 37 37 37 37 37 37 37 37 37 37 37 37 37 37 38 90 90 90 90 
96 90 96 90 90 76 90 90 90 90 90 96 90 90 81 81 90 90 96 90 90 90 64 90 90 90 90 90 90 90 90 90 90 90 90 96 90 90 90 90 90 64 90 90 90 90 90 76 90 90 
76 90 90 90 90 90 90 96 90 64 90 90 90 90 90 90 90 90 90 90 76 90 90 90 90 96 90 90 64 90 90 76 96 90 90 90 90 90 76 90 90 90 90 90 96 96 90 90 90 90 
90 90 90 90 64 90 90 90 90 90 90 90 90 64 90 90 90 96 90 96 90 76 90 64 90 90 90 90 90 90 90 90 90 90 90 90 90 90 64 90 90 64 90 90 90 90 90 90 96 90 
90 90 90 96 90 90 76 90 90 90 96 90 90 90 90 90 64 90 90 90 90 90 90 90 96 90 96 90 90 90 90 90 96 90 90 90 96 90 90 90 90 90 90 96 90 90 90 64 90 90 
